..................................................
..................................................
..................................................
..................................................
..................................................
..................................................
..................................................
..................................................
....................####..........................
................####..............................
............####..................................
........####......................................
..................................................
..@..........*.................*..................
.........................*........................
....................####..........................
...............*..........*.......................
...................................p..............
..............................*...................
.........................................E........
......................................^.....*.....
==================================================
##################################################
