..................................................
..................................................
..................................................
..................................................
..................................................
..................................................
..................................................
...............####...............................
..................................................
..................................................
..@...............................................
..................................................
..........*...............~.......................
....................*.............................
.........................####.....................
..................................................
............................c..........s..........
..................*...............................
...................................!..............
........................................E.........
....................^..........^..................
==================================================
##################################################
