..................................................
..................................................
..................................................
..................................................
..................................................
..................................................
..................................................
..................................................
..................................................
..@...............................................
..................................................
........*....................!....................
......................*...........................
...............####...............................
..................................................
......................c........p..................
...............*..................................
............................b.....................
..................................................
......................................E...........
............^.....~.....^.........................
==================================================
##################################################
